fish - fish
command-not-found - Suggest installation of packages in interactive shell sessions
termux-tools - Some tools for Termux
ack-grep - Tool like grep, optimized for programmers
asciinema - Record and share your terminal sessions, the right way
bash-completion - Programmable completion for the bash shell
curl - Command line tool for transferring data with URL syntax
dialog - Application used in shell scripts which displays text user interface widgets
file - Command-line tool that tells you in words what kind of data a file contains
grep - Command which searches one or more input files for lines containing a match to a specified pattern
git - git
inetutils - Collection of common network programs
less - Terminal pager program used to view the contents of a text file one screen at a time
lftp - FTP/HTTP client and file transfer program
lynx - The text web browser
man - Man page viewer from the mandoc toolset
mc - Midnight Commander - a powerful file manager
mutt - Mail client
neovim - Ambitious Vim-fork focused on extensibility and agility (nvim)
nmap - Utility for network discovery and security auditing
openssh - Secure shell for logging into a remote machine
openssl-tool - The openssl command line cryptographic tool
pwgen - Password generator which by default, unless given the '-s' option, generates memorable but insecure passwords
rsync - Utility that provides fast incremental file transfer

tar - GNU tar for manipulating tar archives
termux-api - Termux API commands
termux-tools - Some tools for Termux
unrar - Tool for extracting files from .rar archives
unzip - Tools for working with zip files
vim-python - Vi IMproved - enhanced vi editor
wcalc - Capable calculator
wget - Commandline tool for retrieving files using HTTP, HTTPS and FTP
zsh - Shell designed for interactive use, although it is also a powerful scripting language
